11111111111111111111111111111111111111111111111111111111111111111111111111111111
11111111111111111111111111111111111000000000000011111111111111111111111111111111
11111111111111111111111111111111111000000000000011111111110000000000011111111111
11100000000111111111111111111111111000000000000000000000000000000000011111111111
11100000000111111111111111111111111000000000000011111111100000000000011111111111
11100000000111111111111111111111111000000000000011111111110000000000011111111111
11100000000111111111111111111111111000000000000011111111110000000000011111111111
11111111011111111111111111111111111111110111111111111111111111111011111111111111
11100000011111111111111111111111000000000111111111111111111000000011111111111111
11000000000000000111111111111100000000000000000000001000000000000000000111111111
11000000000000000111111111000000000000000000000000001000000000000000000111111111
11000000000000000111111111011100000000000000000000001000000000000000000111111111
11000000000000000111111111011100000000000000000000001000000000000000000111111111
11000000000000000000000000011100000000000000000000001000000000000000000111111111
11111111111111111111111111111111111111111111111111111000000000000000000111111111
11111111111111111111111111111111111111111111111111111111111101111111111111111111
11111111111111111111111111111111111111111111111111111111111100000000000011111111
11111111111111111111111111111111111111111111111111111111111110000000000001111111
11111111111111111111111111111111111111111111111111111111111110000000000001111111
11111111111111111111111111111111111111111111111111111111111110000000000001111111
11111111111111111111111111111111111111111111111111111111111110000000000001111111
11111111111111111111111111111111111111111111111111111111111110000000000001111111
11111111111111111111111111111111111111111111111111111111111110000000000001111111
11111111111111111111111111111111111111111111111111111111111111111111111111111111
