11111111111111111111111111111111111111111111111111111111111111111111111111111111
11111111111111111111111111111100000000000011111111111100000000000001111111111111
11111000000000011111111111111100000000000011111111111100000000000001111111111111
11111000000000011100000000000000000000000000000000000000000000000001111111111111
11111000002000011101111111111100040000040011111111111100000040000001111111111111
11111000000000000000000000000000000000000011111111111100000000000001111111111111
11111040000000011111111111111100000000000011111111111100000000000001111111111111
11111111111111111111111111111111111111111111111111111111110111111111111111111111
11111111111111111111111111111111111111111111111111111111110111111111111111111111
11111111111111111111111111111111111111111111111111111111110000000001111111111111
11111111111111111111111111111111111111111111111111111111111111111101111111111111
11111111111111111111111111111111111111111111111111111111000000000000001111111111
11111111111111111111111111111111111111111111111111111111000000000000001111111111
11111111111111111111111111111111111111111111111111111111000040000040001111111111
11111111111111111111111111111111111111111111111111111111000000000000001111111111
11111111111111111111111111111111111111111111111111111111111111111011111111111111
11111111111111111111111111111111111111111111111111111111111111111000000111111111
11111111111111111111111111111111111111111111111111111111100000000000000000000111
11111111111111111111111111111111111111111111111111111111100400000000000000040111
11111111111111111111111111111111111111111111111111111111100000000000000000000111
11111111111111111111111111111111111111111111111111111111100000000003000000000111
11111111111111111111111111111111111111111111111111111111100400000000000000040111
11111111111111111111111111111111111111111111111111111111100000000000000000000111
11111111111111111111111111111111111111111111111111111111111111111111111111111111
