11111111111111111111111111111111111111111111111111111111111111111111111111111111
11111111111111111111111111111111111111111111111111111111111111111111111111111111
11111111111111111111111111111111111111111111111111111111100000000000000001111111
11110000000000000000001111111111111111111111111111111111100000000000000001111111
11110000000000000000001111111111111111111111111111111111100000000300000001111111
11110000000002000000001111111111111111111111111111111111100000000000000001111111
11110000000000000000001111111111111111111111111111111111110111111111111111111111
11111111111111111111101111111111111111111111111111111111110111111111111111111111
11111111111111110000001111111111111111111111111111111111110000000011111111111111
11111111111111110111111111111111111111111111111111111111000000000000000000000111
10000000000000000000000011111111111111111111111111111111000000000000000000000111
10000000000000000000000011111111111111111111111111111111000000000040000000000111
10000004000000000400000011111111111111111111111111111111000000000000000000000111
10000000000000000000000011111111111111111111111111111111000000000000000000000111
11011111111111111111111111111111111111111111111111111111110111111111111111111111
11000001111111111111111111111111111111111111111111111111110000000000000000000111
11111101111111111111111111111111111111111111111111111111111111111111111111110111
10000000000000001111111111111100000000000000011111111111100000000000000000000011
10000000000000001000000000000000000000000000011111111111100000000000000000000011
10000000000000001011111111111100000000000000000000000011100000000000000000000011
10000000000000000011111111111100000000000000011111111000000000000004000000000011
11111111111111111111111111111111111111111111111111111111100000000000000000000011
11111111111111111111111111111111111111111111111111111111100000000000000000000011
11111111111111111111111111111111111111111111111111111111111111111111111111111111
