11111111111111111111111111111111111111111111111111111111111111111111111111111111
11111110000111111111111111111111111111111111111111111111111111110000000000000011
11111110000111111111111111111111110000011111111111111111111111110000000000000011
11111110000000000000000011111111110000011111111111111111111111110000000000000011
11111110000111111111111011111111110000011111111111111111111111110000000000000011
11111111111111111111111011111111110000011111111111111111111111110000000000000011
11111111111111111111111000000000000000000000000000000000000000000000000000000011
11111111111111111111111111111111111111111111111111111111111111111011111111111111
11111111111111111111111111111111111111111111111111111111111111111011111111111111
11111111111111111111111111111111111111111111111111111111111111111011111111111111
11111111111111111111111111111111111111111111111111111111111111111011111111111111
11111111111111111111111111111111111111111111111111111111110000000000011111111111
11111111111111111111111111111111111111111111111111111111110000000000011111111111
11111111111111111111111111111111111111111111111111111111110000000000011111111111
11111111111111111111111111111111111111111111111111111111110000000000011111111111
11111111111111111111111111111111111111111111111111111111111011111111111111111111
11111111111111111111111111111111111111111111111111111111111011111111111111111111
11111111111111111111111111111111111111111111111111111111111000000111111111111111
11111111111111111111111111111111111111111111111111111111111111110111111111111111
11111111111111111111111111111111111111111111111111111111111111000001111111111111
11111111111111111111111111111111111111111111111111111111111111000001111111111111
11111111111111111111111111111111111111111111111111111111111111000001111111111111
11111111111111111111111111111111111111111111111111111111111111000001111111111111
11111111111111111111111111111111111111111111111111111111111111111111111111111111
