11111111111111111111111111111111111111111111111111111111111111111111111111111111
11111111100000000000000000111111111111111111111111111111111111111111111111111111
11111111100000000000000000111111111000000001111111111111111111111100000000011111
11111111100000000200000000000000000000000000000000011111111111111100000000011111
11111111100000000000000000111111111000040001111111011111111111111100000000011111
11111111100000000000000000111111111000000001111111000000000000000000000000011111
11111111111111111111111111111111111111111111111111111111111111111111111011111111
11111111111111111111111111111111111111111111111111111111111111111111111011111111
11111111111111111111111111111111111111111111111111111111111000000000000011111111
11111111111111111111111111111111111111111111111111111111111011111111111111111111
11111111111111111111111111111111111111111111111111111111111011111111111111111111
11111111111111111111111111111111111111111111111111111111100000000000000000000111
11111111111111111111111111111111111111111111111111111111100000000000000000000111
11111111111111111111111111111111111111111111111111111111100000000000000000000111
11111111111111111111111111111111111111111111111111111111100000000000000000000111
11111111111111111111111111111111111111111111111111111111111111111111111111011111
11111111111111111111111111111111111111111111111111111111111111111111111111011111
11111111111111111111111111111111111111111111111111111111100000000000000000011111
11111111111111111111111111111111111111111111111111111111101111111111111111111111
11111111111111111111111111111111111111111111111111111111000000000000000011111111
11111111111111111111111111111111111111111111111111111111000000000000000011111111
11111111111111111111111111111111111111111111111111111111000000003000000011111111
11111111111111111111111111111111111111111111111111111111000000000000000011111111
11111111111111111111111111111111111111111111111111111111111111111111111111111111
