11111111111111111111111111111111111111111111111111111111111111111111111111111111
11100000000000000000000000111111111111111111111111111111111111111111111111111111
11100000000000000000000000111110000000000000000000111111000000000111111111111111
11100000000000000000000000111110000000000000000000111111000000000111111111111111
11100000000000000000000000111110000000000000000000111111000000000111111111111111
11100000000000000000000000111110000000000000000000000000000000000111111111111111
11100000000000000000000000111111111111111101111111111111111111011111111111111111
11111111111111111110111111111111111111111101111111111111111111000111111111111111
11110000000000000000111111111111111111111101111111111111111111110111111111111111
11110111111111111111111111111111100000000000000000001111110000000000000000011111
11000000000000000000000001111111100000000000000000001111110000000000000000011111
11000000000000000000000001111111100000000000000000001111110000000000000000011111
11000000000000000000000001111111100000000000000000001111110000000000000000011111
11000000000000000000000000000000000000000000000000001111110000000000000000011111
11111111111111111111111111111111111111111111111111111111111111111111110111111111
11111111111111111111111111111111111111111111111111111111111111111111110111111111
11111111111111111111111111111111111111111111111111111111111111111111100111111111
11111111111111111111111111111111111111111111111111111100000000000000000000011111
11111111111111111111111111111111111111111111111111111100000000000000000000011111
11111111111111111111111111111111111111111111111111111100000000000000000000011111
11111111111111111111111111111111111111111111111111111100000000000000000000011111
11111111111111111111111111111111111111111111111111111100000000000000000000011111
11111111111111111111111111111111111111111111111111111111111111111111111111111111
11111111111111111111111111111111111111111111111111111111111111111111111111111111
