10000000000011111111111111100000000000000000000001111000000000000000000000111111
10000000000011111111111111100000000000000000000001111000000000000000000000111111
10000000000011111111111111100000000000000000000001111000000000000000000000111111
10000000000011111111111111100000000000000000000001111000000000000000000000111111
11111111111111111111111111111111111111111111111111111111111111111111111111111111
11111111111111111111111111111111111111111111111111111111111111111111111111111111
11111111111111111111111111111111111111111111111111111111111111111111111111111111
11111111111111111111111111111111111111111111111111111111111111111111111111111111
11111111111111111111111111111111111111111111111111111000000000000001111111111111
11111111111111111111111111111111111111111111111111111000000000000001111111111111
11111111111111111111111111111111111111111111111111111000000000000001111111111111
11111111111111111111111111111111111111111111111111111000000000000001111111111111
11111111111111111111111111111111111111111111111111111000000000000001111111111111
11111111111111111111111111111111111111111111111111111111111111111111111111111111
11111111111111111111111111111111111111111111111111111111111111111111111111111111
11111111111111111111111111111111111111111111111111111111111111111111111111111111
11111111111111111111111111111111111111111111111111111000000000000000000000111111
11111111111111111111111111111111111111111111111111111000000000000000000000111111
11111111111111111111111111111111111111111111111111111000000000000000000000111111
11111111111111111111111111111111111111111111111111111000000000000000000000111111
11111111111111111111111111111111111111111111111111111000000000000000000000111111
11111111111111111111111111111111111111111111111111111111111111111111111111111111
11111111111111111111111111111111111111111111111111111111111111111111111111111111
11111111111111111111111111111111111111111111111111111111111111111111111111111111
