11111111111111111111111111111111111111111111111111111111111111111111111111111111
11111111111111000000000000111111111111100000111111111111111111111111111111111111
11111111111111000000000000111111111111100000111111111100000000000000000000000111
11111111111111000000000000111111111111100000111111111100000000000000000000000111
11111111111111000000000000111111111111100000111111111100000000000000000000000111
11111111111111000000000000111111111111100000111111111100000000000000000000000111
11111111111111111111111111111111111111100000111111111111111111111111111111111111
11111111111111111111111111111111111111111111111111111111111111111111111111111111
11111111111111111111111111111111111111111111111111111111111111111111111111111111
11110000000000000000000001111111100000000000001111111111111100000000001111111111
11110000000000000000000001111111100000000000001111111111111100000000001111111111
11110000000000000000000001111111100000000000001111111111111100000000001111111111
11110000000000000000000001111111100000000000001111111111111100000000001111111111
11110000000000000000000001111111100000000000001111111111111111111111111111111111
11110000000000000000000001111111100000000000001111111111111111111111111111111111
11111111111111111111111111111111111111111111111111111111111111111111111111111111
11111111111111111111111111111111111111111111111111111111111111111111111111111111
11111111111111111111111111100000000111111111111111111111111000000000000000000011
11111111111111111111111111100000000111111111111111111111111000000000000000000011
11111111111111111111111111100000000111111111111111111111111000000000000000000011
11111111111111111111111111100000000111111111111111111111111000000000000000000011
11111111111111111111111111111111111111111111111111111111111000000000000000000011
11111111111111111111111111111111111111111111111111111111111111111111111111111111
11111111111111111111111111111111111111111111111111111111111111111111111111111111
