10000000000000000000001111111111111111111111111111111000000000000000111111111111
10000000000000000000001111111111111111111111111111111000000000000000111111111111
10000000000000000000001111111111111111111111111111111000000000000000111111111111
10000000000000000000001111111111111111111111111111111000000000000000111111111111
10000000000000000000001111111111111111111111111111111111111111111111111111111111
11111111111111111111111111111111111111111111111111111111111111111111111111111111
11111111111111111111111111111111111111111111111111111111111111111111111111111111
11111111111111111111111111111111111111111111111111111111111111111111111111111111
10000000000000011111111111111111111111111111111111111000000000000111111111111111
10000000000000011111111111111111111111111111111111111000000000000111111111111111
10000000000000011111111111111111111111111111111111111000000000000111111111111111
10000000000000011111111111111111111111111111111111111000000000000111111111111111
11111111111111111111111111111111111111111111111111111000000000000111111111111111
11111111111111111111111111111111111111111111111111111000000000000111111111111111
11111111111111111111111111111111111111111111111111111111111111111111111111111111
11111111111111111111111111111111111111111111111111111111111111111111111111111111
10000000000000000000000000100000000000000000000000001000011111111111111111111111
10000000000000000000000000100000000000000000000000001000011111111111111111111111
10000000000000000000000000100000000000000000000000001000011111111111111111111111
10000000000000000000000000100000000000000000000000001000011111111111111111111111
10000000000000000000000000111111111111111111111111111000011111111111111111111111
11111111111111111111111111111111111111111111111111111000011111111111111111111111
11111111111111111111111111111111111111111111111111111111111111111111111111111111
11111111111111111111111111111111111111111111111111111111111111111111111111111111
