11111111111111111111111111111111111111111111111111111111111111111111111111111111
11110000000000000000000011111111111111111111111111111111111111111111111111111111
11110000000000000000000011111111111111111111111111111111111111111111111111111111
11110000000000000000000011111111111111111111111111111111111111111111111111111111
11110000000000000000000011111111111111111111111111111111111111111111111111111111
11110000000000000000000011111111111111111111111111111111111111111111111111111111
11110000000000000000000011111111111111111111111111111111111111111111111111111111
11111101111111111111111111111111111111111111111111111111111111111111111111111111
11111101111111111111111111111111111111111111111111111111111111111111111111111111
11111100000000111111111111111111110000000000000000011111111111111111111111111111
11111111110000000000011111111111110000000000000000000011000000000000000000011111
11111111110000000000011111111111110000000000000000011011000000000000000000011111
11111111110000000000000000000001110000000000000000011000000000000000000000011111
11111111110000000000011111111101110000000000000000011111000000000000000000011111
11111111110000000000011111111100000000000000000000011111111111111111110111111111
11111111111111111111111111111111111111111111111111111111111111111111110111111111
11111111111111111111111111111111111111111111111111111111111111111111110111111111
11111111111111111111111111111111111111111111111111111111111110000000000111111111
11111111111111111111111111111111111111111111111111111110000000000111111111111111
11111111111111111111111111111111111111111111111111111110000000000111111111111111
11111111111111111111111111111111111111111111111111111110000000000111111111111111
11111111111111111111111111111111111111111111111111111110000000000111111111111111
11111111111111111111111111111111111111111111111111111110000000000111111111111111
11111111111111111111111111111111111111111111111111111111111111111111111111111111
