10000000000000001111111111100000000000000000000000111000000000000000000111111111
10000000000000001111111111100000000000000000000000111000000000000000000111111111
10000000000000001111111111100000000000000000000000111000000000000000000111111111
10000000000000001111111111100000000000000000000000111000000000000000000111111111
10000000000000001111111111100000000000000000000000111000000000000000000111111111
11111111111111111111111111100000000000000000000000111000000000000000000111111111
11111111111111111111111111100000000000000000000000111111111111111111111111111111
11111111111111111111111111111111111111111111111111111111111111111111111111111111
10000000001111111111111111100000000000111111111111111000000000000000111111111111
10000000001111111111111111100000000000111111111111111000000000000000111111111111
10000000001111111111111111100000000000111111111111111000000000000000111111111111
10000000001111111111111111100000000000111111111111111000000000000000111111111111
10000000001111111111111111111111111111111111111111111111111111111111111111111111
11111111111111111111111111111111111111111111111111111111111111111111111111111111
11111111111111111111111111111111111111111111111111111111111111111111111111111111
11111111111111111111111111111111111111111111111111111111111111111111111111111111
10000001111111111111111111100000001111111111111111111000001111111111111111111111
10000001111111111111111111100000001111111111111111111000001111111111111111111111
10000001111111111111111111100000001111111111111111111000001111111111111111111111
10000001111111111111111111100000001111111111111111111000001111111111111111111111
10000001111111111111111111111111111111111111111111111000001111111111111111111111
10000001111111111111111111111111111111111111111111111111111111111111111111111111
11111111111111111111111111111111111111111111111111111111111111111111111111111111
11111111111111111111111111111111111111111111111111111111111111111111111111111111
